*****     ****
**      S  ***
**         ***
***  *********
*            *
* ********** *
* ********** *
   ********* *
 * ********* *
 * ********* *
 * ********* *
 * ********* *
G*************