****S****
*       *
  ***** *
*       *
**** ** *
**** ****
*       *
  ***** *
*       *
**** ** *
**** ****
*       *
  ***** *
*       *
**** ** *
**** ****
*       *
  ***** *
*       *
****G** *