****G****
*       *
  ***** *
*       *
**** ** *
*  * *  *
*       *
******* *
*       *
* ** ** *
* ** ****
* *     *
  ***** *
**      *
**** ** *
**** ****
*       *
  ***** *
*       *
****S** *