
***********
*    S    *
*         *
*         *
*         *
*    G    *
***********
